"filename", "language", "JavaScript", "CSS", "Markdown", "JSON", "HTML", "comment", "blank", "total"
"d:\VscodeField\ChongJun\README.md", "Markdown", 0, 0, 38, 0, 0, 0, 33, 71
"d:\VscodeField\ChongJun\package-lock.json", "JSON", 0, 0, 0, 12034, 0, 0, 1, 12035
"d:\VscodeField\ChongJun\package.json", "JSON", 0, 0, 0, 45, 0, 0, 1, 46
"d:\VscodeField\ChongJun\public\index.html", "HTML", 0, 0, 0, 0, 20, 23, 1, 44
"d:\VscodeField\ChongJun\public\manifest.json", "JSON", 0, 0, 0, 25, 0, 0, 1, 26
"d:\VscodeField\ChongJun\src\App.js", "JavaScript", 17, 0, 0, 0, 0, 1, 3, 21
"d:\VscodeField\ChongJun\src\IRouter.js", "JavaScript", 215, 0, 0, 0, 0, 21, 5, 241
"d:\VscodeField\ChongJun\src\apis\admin.js", "JavaScript", 452, 0, 0, 0, 0, 32, 3, 487
"d:\VscodeField\ChongJun\src\apis\company.js", "JavaScript", 396, 0, 0, 0, 0, 28, 5, 429
"d:\VscodeField\ChongJun\src\apis\urls.js", "JavaScript", 97, 0, 0, 0, 0, 70, 5, 172
"d:\VscodeField\ChongJun\src\apis\verification.js", "JavaScript", 42, 0, 0, 0, 0, 0, 1, 43
"d:\VscodeField\ChongJun\src\component\centerRow\centerRow.js", "JavaScript", 14, 0, 0, 0, 0, 0, 2, 16
"d:\VscodeField\ChongJun\src\component\menu\menu.css", "CSS", 0, 0, 0, 0, 0, 0, 1, 1
"d:\VscodeField\ChongJun\src\component\menu\menu.js", "JavaScript", 119, 0, 0, 0, 0, 13, 10, 142
"d:\VscodeField\ChongJun\src\component\table\AccountTable\AccountTable.js", "JavaScript", 268, 0, 0, 0, 0, 0, 6, 274
"d:\VscodeField\ChongJun\src\component\table\AdminTable\AdminTable.js", "JavaScript", 174, 0, 0, 0, 0, 0, 4, 178
"d:\VscodeField\ChongJun\src\component\table\CarouselTable\CarouselTable.js", "JavaScript", 181, 0, 0, 0, 0, 0, 6, 187
"d:\VscodeField\ChongJun\src\component\table\EJobTable\EJobTable.js", "JavaScript", 124, 0, 0, 0, 0, 0, 7, 131
"d:\VscodeField\ChongJun\src\component\table\EResumeTable\EResumeTable.js", "JavaScript", 65, 0, 0, 0, 0, 0, 4, 69
"d:\VscodeField\ChongJun\src\component\table\ESpecialRecruitmentTable\ESpecialRecruitmentTable.js", "JavaScript", 86, 0, 0, 0, 0, 0, 3, 89
"d:\VscodeField\ChongJun\src\component\table\EnterpriseAccountTable\EnterpriseAccountTable.js", "JavaScript", 89, 0, 0, 0, 0, 26, 2, 117
"d:\VscodeField\ChongJun\src\component\table\EnterpriseAuditTable\EnterpriseAuditTable.js", "JavaScript", 123, 0, 0, 0, 0, 0, 3, 126
"d:\VscodeField\ChongJun\src\component\table\EnterpriseTable\EnterpriseTable.js", "JavaScript", 63, 0, 0, 0, 0, 0, 2, 65
"d:\VscodeField\ChongJun\src\component\table\JobTable\JobTable.js", "JavaScript", 118, 0, 0, 0, 0, 0, 7, 125
"d:\VscodeField\ChongJun\src\component\table\ResumeTable\ResumeTable.js", "JavaScript", 74, 0, 0, 0, 0, 0, 3, 77
"d:\VscodeField\ChongJun\src\component\table\SpecialRecruitmentTable\SpecialRecruitmentTable.js", "JavaScript", 80, 0, 0, 0, 0, 0, 3, 83
"d:\VscodeField\ChongJun\src\config\BackstageMenuConfig.js", "JavaScript", 71, 0, 0, 0, 0, 29, 2, 102
"d:\VscodeField\ChongJun\src\config\EnterpriseMenuConfig.js", "JavaScript", 27, 0, 0, 0, 0, 1, 2, 30
"d:\VscodeField\ChongJun\src\config\adminType.js", "JavaScript", 4, 0, 0, 0, 0, 2, 1, 7
"d:\VscodeField\ChongJun\src\config\area.js", "JavaScript", 36, 0, 0, 0, 0, 2, 1, 39
"d:\VscodeField\ChongJun\src\config\companyType.js", "JavaScript", 1, 0, 0, 0, 0, 2, 1, 4
"d:\VscodeField\ChongJun\src\config\educationRequire.js", "JavaScript", 1, 0, 0, 0, 0, 2, 1, 4
"d:\VscodeField\ChongJun\src\config\expRequire.js", "JavaScript", 1, 0, 0, 0, 0, 2, 1, 4
"d:\VscodeField\ChongJun\src\config\jobType.js", "JavaScript", 1, 0, 0, 0, 0, 2, 1, 4
"d:\VscodeField\ChongJun\src\index.css", "CSS", 0, 3, 0, 0, 0, 1, 1, 5
"d:\VscodeField\ChongJun\src\index.js", "JavaScript", 10, 0, 0, 0, 0, 0, 3, 13
"d:\VscodeField\ChongJun\src\utils\clearName.js", "JavaScript", 3, 0, 0, 0, 0, 0, 1, 4
"d:\VscodeField\ChongJun\src\utils\clearToken.js", "JavaScript", 3, 0, 0, 0, 0, 0, 0, 3
"d:\VscodeField\ChongJun\src\utils\http.js", "JavaScript", 240, 0, 0, 0, 0, 54, 25, 319
"d:\VscodeField\ChongJun\src\view\BackstageManagement\AuthorityManagement\AccountManagement\AccountManagement.css", "CSS", 0, 0, 0, 0, 0, 0, 1, 1
"d:\VscodeField\ChongJun\src\view\BackstageManagement\AuthorityManagement\AccountManagement\AccountManagement.js", "JavaScript", 46, 0, 0, 0, 0, 0, 3, 49
"d:\VscodeField\ChongJun\src\view\BackstageManagement\AuthorityManagement\AdminReview\AdminReview.css", "CSS", 0, 0, 0, 0, 0, 0, 1, 1
"d:\VscodeField\ChongJun\src\view\BackstageManagement\AuthorityManagement\AdminReview\AdminReview.js", "JavaScript", 45, 0, 0, 0, 0, 0, 4, 49
"d:\VscodeField\ChongJun\src\view\BackstageManagement\BillingManagement\BillingInformationCheck\BillingInformationCheck.css", "CSS", 0, 0, 0, 0, 0, 0, 1, 1
"d:\VscodeField\ChongJun\src\view\BackstageManagement\BillingManagement\BillingInformationCheck\BillingInformationCheck.js", "JavaScript", 11, 0, 0, 0, 0, 0, 2, 13
"d:\VscodeField\ChongJun\src\view\BackstageManagement\BillingManagement\BillingInformationProcessing\BillingInformationProcessing.css", "CSS", 0, 0, 0, 0, 0, 0, 1, 1
"d:\VscodeField\ChongJun\src\view\BackstageManagement\BillingManagement\BillingInformationProcessing\BillingInformationProcessing.js", "JavaScript", 11, 0, 0, 0, 0, 0, 4, 15
"d:\VscodeField\ChongJun\src\view\BackstageManagement\BusinessManagement\EnterpriseAccountManagement\EnterpriseAccountManagement.css", "CSS", 0, 0, 0, 0, 0, 0, 1, 1
"d:\VscodeField\ChongJun\src\view\BackstageManagement\BusinessManagement\EnterpriseAccountManagement\EnterpriseAccountManagement.js", "JavaScript", 61, 0, 0, 0, 0, 0, 4, 65
"d:\VscodeField\ChongJun\src\view\BackstageManagement\BusinessManagement\EnterpriseAudit\EnterpriseAudit.css", "CSS", 0, 0, 0, 0, 0, 0, 1, 1
"d:\VscodeField\ChongJun\src\view\BackstageManagement\BusinessManagement\EnterpriseAudit\EnterpriseAudit.js", "JavaScript", 45, 0, 0, 0, 0, 0, 3, 48
"d:\VscodeField\ChongJun\src\view\BackstageManagement\BusinessManagement\EnterpriseDetails\EnterpriseDetails.css", "CSS", 0, 0, 0, 0, 0, 0, 1, 1
"d:\VscodeField\ChongJun\src\view\BackstageManagement\BusinessManagement\EnterpriseDetails\EnterpriseDetails.js", "JavaScript", 81, 0, 0, 0, 0, 0, 3, 84
"d:\VscodeField\ChongJun\src\view\BackstageManagement\ChongjunEmployment\JobDatabase\JobDatabase.css", "CSS", 0, 0, 0, 0, 0, 0, 1, 1
"d:\VscodeField\ChongJun\src\view\BackstageManagement\ChongjunEmployment\JobDatabase\JobDatabase.js", "JavaScript", 123, 0, 0, 0, 0, 0, 5, 128
"d:\VscodeField\ChongJun\src\view\BackstageManagement\ChongjunEmployment\ResumeDatabase\ResumeDatabase.css", "CSS", 0, 0, 0, 0, 0, 0, 1, 1
"d:\VscodeField\ChongJun\src\view\BackstageManagement\ChongjunEmployment\ResumeDatabase\ResumeDatabase.js", "JavaScript", 111, 0, 0, 0, 0, 0, 3, 114
"d:\VscodeField\ChongJun\src\view\BackstageManagement\ChongjunEmployment\SpecialRecruitment\SpecialRecruitment.css", "CSS", 0, 0, 0, 0, 0, 0, 1, 1
"d:\VscodeField\ChongJun\src\view\BackstageManagement\ChongjunEmployment\SpecialRecruitment\SpecialRecruitment.js", "JavaScript", 52, 0, 0, 0, 0, 0, 4, 56
"d:\VscodeField\ChongJun\src\view\BackstageManagement\CourseManagement\AllOrders\AllOrders.css", "CSS", 0, 0, 0, 0, 0, 0, 1, 1
"d:\VscodeField\ChongJun\src\view\BackstageManagement\CourseManagement\AllOrders\AllOrders.js", "JavaScript", 11, 0, 0, 0, 0, 0, 3, 14
"d:\VscodeField\ChongJun\src\view\BackstageManagement\CourseManagement\RefundProcessing\RefundProcessing.css", "CSS", 0, 0, 0, 0, 0, 0, 1, 1
"d:\VscodeField\ChongJun\src\view\BackstageManagement\CourseManagement\RefundProcessing\RefundProcessing.js", "JavaScript", 11, 0, 0, 0, 0, 0, 4, 15
"d:\VscodeField\ChongJun\src\view\BackstageManagement\Detail\EnterpriseDetail\EnterpriseDetail.css", "CSS", 0, 0, 0, 0, 0, 0, 1, 1
"d:\VscodeField\ChongJun\src\view\BackstageManagement\Detail\EnterpriseDetail\EnterpriseDetail.js", "JavaScript", 102, 0, 0, 0, 0, 0, 3, 105
"d:\VscodeField\ChongJun\src\view\BackstageManagement\Detail\JobDetail\JobDetail.css", "CSS", 0, 3, 0, 0, 0, 0, 0, 3
"d:\VscodeField\ChongJun\src\view\BackstageManagement\Detail\JobDetail\JobDetail.js", "JavaScript", 189, 0, 0, 0, 0, 0, 3, 192
"d:\VscodeField\ChongJun\src\view\BackstageManagement\Detail\ResumeDetail\ResumeDetail.css", "CSS", 0, 3, 0, 0, 0, 0, 0, 3
"d:\VscodeField\ChongJun\src\view\BackstageManagement\Detail\ResumeDetail\ResumeDetail.js", "JavaScript", 273, 0, 0, 0, 0, 0, 3, 276
"d:\VscodeField\ChongJun\src\view\BackstageManagement\Detail\SpecialDetail\SpecialDetail.css", "CSS", 0, 0, 0, 0, 0, 0, 1, 1
"d:\VscodeField\ChongJun\src\view\BackstageManagement\Detail\SpecialDetail\SpecialDetail.js", "JavaScript", 126, 0, 0, 0, 0, 0, 4, 130
"d:\VscodeField\ChongJun\src\view\BackstageManagement\DisplayManagement\AboutUs\AboutUs.css", "CSS", 0, 3, 0, 0, 0, 0, 0, 3
"d:\VscodeField\ChongJun\src\view\BackstageManagement\DisplayManagement\AboutUs\AboutUs.js", "JavaScript", 278, 0, 0, 0, 0, 0, 12, 290
"d:\VscodeField\ChongJun\src\view\BackstageManagement\DisplayManagement\CarouselSettings\CarouselSettings.css", "CSS", 0, 0, 0, 0, 0, 0, 1, 1
"d:\VscodeField\ChongJun\src\view\BackstageManagement\DisplayManagement\CarouselSettings\CarouselSettings.js", "JavaScript", 44, 0, 0, 0, 0, 0, 3, 47
"d:\VscodeField\ChongJun\src\view\BackstageManagement\DisplayManagement\PrivacyAgreement\PrivacyAgreement.css", "CSS", 0, 3, 0, 0, 0, 0, 1, 4
"d:\VscodeField\ChongJun\src\view\BackstageManagement\DisplayManagement\PrivacyAgreement\PrivacyAgreement.js", "JavaScript", 99, 0, 0, 0, 0, 0, 4, 103
"d:\VscodeField\ChongJun\src\view\EnterpriseManagement\CorporateInformation\CorporateInformation.css", "CSS", 0, 0, 0, 0, 0, 0, 1, 1
"d:\VscodeField\ChongJun\src\view\EnterpriseManagement\CorporateInformation\CorporateInformation.js", "JavaScript", 120, 0, 0, 0, 0, 0, 4, 124
"d:\VscodeField\ChongJun\src\view\EnterpriseManagement\Detail\EPositionResumeDetail\EPositionResumeDetail.css", "CSS", 0, 0, 0, 0, 0, 0, 1, 1
"d:\VscodeField\ChongJun\src\view\EnterpriseManagement\Detail\EPositionResumeDetail\EPositionResumeDetail.js", "JavaScript", 132, 0, 0, 0, 0, 0, 3, 135
"d:\VscodeField\ChongJun\src\view\EnterpriseManagement\Detail\EResumeDetail\EResumeDetail.css", "CSS", 0, 0, 0, 0, 0, 0, 1, 1
"d:\VscodeField\ChongJun\src\view\EnterpriseManagement\Detail\EResumeDetail\EResumeDetail.js", "JavaScript", 77, 0, 0, 0, 0, 0, 4, 81
"d:\VscodeField\ChongJun\src\view\EnterpriseManagement\Detail\ESpecialDetail\ESpecialDetail.css", "CSS", 0, 0, 0, 0, 0, 0, 1, 1
"d:\VscodeField\ChongJun\src\view\EnterpriseManagement\Detail\ESpecialDetail\ESpecialDetail.js", "JavaScript", 137, 0, 0, 0, 0, 0, 4, 141
"d:\VscodeField\ChongJun\src\view\EnterpriseManagement\Detail\ESpecialJobDetail\ESpecialJobDetail.css", "CSS", 0, 0, 0, 0, 0, 0, 1, 1
"d:\VscodeField\ChongJun\src\view\EnterpriseManagement\Detail\ESpecialJobDetail\ESpecialJobDetail.js", "JavaScript", 91, 0, 0, 0, 0, 0, 4, 95
"d:\VscodeField\ChongJun\src\view\EnterpriseManagement\Detail\EjobDetail\EjobDetail.css", "CSS", 0, 0, 0, 0, 0, 0, 1, 1
"d:\VscodeField\ChongJun\src\view\EnterpriseManagement\Detail\EjobDetail\EjobDetail.js", "JavaScript", 195, 0, 0, 0, 0, 0, 3, 198
"d:\VscodeField\ChongJun\src\view\EnterpriseManagement\EAccountManagement\EaccountManagement\EAccountManagement.css", "CSS", 0, 0, 0, 0, 0, 0, 1, 1
"d:\VscodeField\ChongJun\src\view\EnterpriseManagement\EAccountManagement\EaccountManagement\EAccountManagement.js", "JavaScript", 48, 0, 0, 0, 0, 0, 3, 51
"d:\VscodeField\ChongJun\src\view\EnterpriseManagement\EAccountManagement\EadminReview\EAdminReview.css", "CSS", 0, 0, 0, 0, 0, 0, 1, 1
"d:\VscodeField\ChongJun\src\view\EnterpriseManagement\EAccountManagement\EadminReview\EAdminReview.js", "JavaScript", 47, 0, 0, 0, 0, 0, 4, 51
"d:\VscodeField\ChongJun\src\view\EnterpriseManagement\Edit\EditCorporateInformation\EditCorporateInformation.css", "CSS", 0, 0, 0, 0, 0, 0, 1, 1
"d:\VscodeField\ChongJun\src\view\EnterpriseManagement\Edit\EditCorporateInformation\EditCorporateInformation.js", "JavaScript", 298, 0, 0, 0, 0, 1, 6, 305
"d:\VscodeField\ChongJun\src\view\EnterpriseManagement\Edit\EditPersonalInfo\EditPersonalInfo.css", "CSS", 0, 0, 0, 0, 0, 0, 1, 1
"d:\VscodeField\ChongJun\src\view\EnterpriseManagement\Edit\EditPersonalInfo\EditPersonalInfo.js", "JavaScript", 106, 0, 0, 0, 0, 0, 4, 110
"d:\VscodeField\ChongJun\src\view\EnterpriseManagement\Edit\EditPositon\EditPositon.css", "CSS", 0, 0, 0, 0, 0, 0, 1, 1
"d:\VscodeField\ChongJun\src\view\EnterpriseManagement\Edit\EditPositon\EditPositon.js", "JavaScript", 389, 0, 0, 0, 0, 0, 4, 393
"d:\VscodeField\ChongJun\src\view\EnterpriseManagement\JobManagement\JobManagement.css", "CSS", 0, 0, 0, 0, 0, 0, 1, 1
"d:\VscodeField\ChongJun\src\view\EnterpriseManagement\JobManagement\JobManagement.js", "JavaScript", 123, 0, 0, 0, 0, 0, 5, 128
"d:\VscodeField\ChongJun\src\view\EnterpriseManagement\PersonalInformation\PersonalInformation.css", "CSS", 0, 3, 0, 0, 0, 0, 0, 3
"d:\VscodeField\ChongJun\src\view\EnterpriseManagement\PersonalInformation\PersonalInformation.js", "JavaScript", 190, 0, 0, 0, 0, 0, 5, 195
"d:\VscodeField\ChongJun\src\view\EnterpriseManagement\SpecialRecruitment\SpecialRecruitment.css", "CSS", 0, 0, 0, 0, 0, 0, 1, 1
"d:\VscodeField\ChongJun\src\view\EnterpriseManagement\SpecialRecruitment\SpecialRecruitment.js", "JavaScript", 44, 0, 0, 0, 0, 0, 4, 48
"d:\VscodeField\ChongJun\src\view\NotMatch\NotMatch.css", "CSS", 0, 10, 0, 0, 0, 0, 0, 10
"d:\VscodeField\ChongJun\src\view\NotMatch\NotMatch.js", "JavaScript", 18, 0, 0, 0, 0, 0, 3, 21
"d:\VscodeField\ChongJun\src\view\admin\admin.css", "CSS", 0, 16, 0, 0, 0, 0, 4, 20
"d:\VscodeField\ChongJun\src\view\admin\admin.js", "JavaScript", 70, 0, 0, 0, 0, 1, 4, 75
"d:\VscodeField\ChongJun\src\view\forget\forget.css", "CSS", 0, 34, 0, 0, 0, 0, 1, 35
"d:\VscodeField\ChongJun\src\view\forget\forget.js", "JavaScript", 276, 0, 0, 0, 0, 2, 7, 285
"d:\VscodeField\ChongJun\src\view\login\login.css", "CSS", 0, 31, 0, 0, 0, 0, 1, 32
"d:\VscodeField\ChongJun\src\view\login\login.js", "JavaScript", 358, 0, 0, 0, 0, 6, 9, 373
"d:\VscodeField\ChongJun\src\view\signup\signup.css", "CSS", 0, 34, 0, 0, 0, 0, 1, 35
"d:\VscodeField\ChongJun\src\view\signup\signup.js", "JavaScript", 325, 0, 0, 0, 0, 2, 9, 336
"Total", "-", 7958, 143, 38, 12104, 20, 323, 361, 20947